NO ./textures/TECH_0E.xpm
SO ./textures/TEH_2B.xpm
WE ./textures/TECH_3D.xpm
EA ./textures/TECH_4C.xpm
F 120, 66, 18
C 23, 32, 42

1111111111111111111111111111111111111
1100000000000000001110001000000000111
1111111111110000000000001111000000011
1100000000000110001000001000001111111
11100N0000111000000001111000000000011
1110000000100111110000000100000001111
1010000000100000000000000111111111111
1110000001100011000000000000001111111
1111111111111111111111111111111111111
