NO ./textures/TECH_0E.xpm
SO ./textures/TECH_2B.xpm

EA ./textures/TECH_4C.xpm
F 120, 66, 18
C 23, 32, 42

1111111111111111111111111111111111111
1100000000000000001110001000000000111
1111121111110000000000001111000000011
1100000000000110001000002000001111111
11100N0001111000000001211000000000011
1120000000200111110000000100000001111
1010000012100000000000000111211111111
1110000001100011000000000000001111111
1111111111111111111111111111111111111